11111111111111
1G010000000001
1PC00110G01101
100011E0000001
11111111111111