1111111111111
1001000000001
1GC001011G0C1
1P0011E000001
1111111111111