11111111111111
10010000000011
10C001110G0011
1P0011E0000011
11111111111111
11111111111111