1111111111111
1001000000001
10C0011111G01
1P0011E000001
1111111111111