1111111111111
1001000000001
10C0011100G01
1P0011E000001
1111111111111