11111111111111
10010000000001
1PC0011G001101
100011E0000001
11111111111111