11111111
10G010E1
1G000001
1P0000C1
11111111